0 Poisson_pané #00ffff 1 0 4.7
1 Sol #c0c0c0 1 1 5

1 1 1 1 0
1 x 0 x x
1 x x x x
1 x x x x
1 1 1 0 x

1 0 0 0 0
1 0 0 0 0
1 0 0 0 0
0 0 0 0 0
0 0 0 0 0
